15 10
0000 0000 0000 0000 0000 0000 0000 0000 0000 0000 0000 0000 0000 0000 0000
0000 1111 1100 1111 1100 1111 1100 1111 1100 1111 1100 1111 1100 0011 0000
0000 1111 0000 1111 0000 1111 0000 1111 0000 1111 0000 1111 0000 1111 0000
0000 1111 0000 1111 0000 1111 0000 1111 0000 1111 0000 1111 0000 1111 0000
0000 1111 0000 1111 0000 1111 0000 1111 0000 1111 0000 1111 0000 1111 0000
0000 1111 0000 1111 0000 1111 0000 1111 0000 1111 0000 1111 0000 1111 0000
0000 1111 0000 1111 0000 1111 0000 1111 0000 1111 0000 1111 0000 1111 0000
0000 1111 0000 1111 0000 1111 0000 1111 0000 1111 0000 1111 0000 1111 0000
0000 1100 0011 1111 0011 1111 0011 1111 0011 1111 0011 1111 0011 1111 0000
0000 0000 0000 0000 0000 0000 0000 0000 0000 0000 0000 0000 0000 0000 0000
1 0 2
7
M 0 2 2
L 0 3 50
M 0 3 3
G 0 0 0
C 2 2
B 1 2
D 1 3
3
F 1 3 L 0
S 1 3 L
H 0 3 L
180
