15 10
0000 0000 0000 0000 0000 0000 0000 0000 0000 0000 0000 0000 0000 0000 0000
0000 1111 1100 1111 1100 1111 1100 1111 1100 1111 1100 1111 1100 0011 0000
0000 1111 0000 1111 0000 1111 0000 1111 0000 1111 0000 1111 0000 1111 0000
0000 1111 0000 1111 0000 1111 0000 1111 0000 1111 0000 1111 0000 1111 0000
0000 1111 0000 1111 0000 1111 0000 1111 0000 1111 0000 2222 0000 1111 0000
0000 1111 0000 1111 0000 1111 0000 1111 0000 1111 0202 2222 0000 1111 0000
0000 1111 0000 1111 0000 1111 0000 1111 0000 1111 0000 2222 0000 1111 0000
0000 1111 0000 1111 0000 1111 0000 1111 0000 1111 0000 1111 0000 1111 0000
0000 1100 0011 1111 0011 1111 0011 1111 0011 1111 0011 1111 0011 1111 0000
0000 0000 0000 0000 0000 0000 0000 0000 0000 0000 0000 0000 0000 0000 0000
0 0 1
10
L 13 3 0
L 6 7 3
M 0 4 50
M 5 3 150
M 11 5 100
G 10 5 0
G 13 1 4
C 2 7
B 13 7
D 14 9
3
F 1 3 L 0
S 1 3 L
H 0 3 L
180
