15 10
0000 0000 0000 0000 0000 0000 0000 0000 0000 0000 0000 0000 0000 0000 0000
0000 1111 1100 1111 1100 1111 1100 1111 1100 1111 1100 1111 1100 0011 0000
0000 1111 0000 1111 0000 1111 0000 1111 0000 1111 0000 1111 0000 1111 0000
0000 1111 0000 1111 0000 1111 0000 1111 0000 1111 0000 1111 0000 1111 0000
0000 1111 0000 1111 0000 1111 0000 1111 0000 1111 0000 2222 0000 1111 0000
0000 1111 0000 1111 0000 1111 0000 1111 0000 1111 0202 2222 0000 1111 0000
0000 1111 0000 1111 0000 1111 0000 1111 0000 1111 0000 2222 0000 1111 0000
0000 1111 0000 1111 0000 1111 0000 1111 0000 1111 0000 1111 0000 1111 0000
0000 1100 0011 1111 0011 1111 0011 1111 0011 1111 0011 1111 0011 1111 0000
0000 0000 0000 0000 0000 0000 0000 0000 0000 0000 0000 0000 0000 0000 0000
0 0 1
17
G 10 5 0
G 13 1 3
G 14 8 2
G 13 9 2
L 13 2 0
L 6 7 3
L 11 4 2
M 0 4 50
M 6 0 50
M 2 7 100
M 11 6 100
M 7 5 150
M 3 3 250
C 0 9
C 14 0
B 6 6
D 14 9
3
S 12 9 L
F 5 8 L 1
H 0 2 L
69
