15 10
2222 2222 2222 2222 2222 2222 2222 2222 2222 2222 2222 2222 2222 2222 2222
2222 2222 2255 2222 2222 2222 2222 2222 2222 2222 2222 2222 2222 2222 2222
2222 2525 5555 5252 2222 2222 2222 4444 4444 4444 4444 4444 4444 4444 2222
2222 2222 5522 2222 2222 2222 2222 2222 4444 4444 4444 4444 4444 2222 2222
2222 2222 2222 2222 2222 2222 2222 2222 2222 4444 4444 4444 2222 2222 2222
2222 2222 2222 2222 2211 2222 2222 2222 2222 2222 4422 2222 2222 2222 2222
2222 2222 2222 1111 1111 1111 2222 2222 2222 2222 2222 2222 2233 2222 2222
2222 2222 1111 1111 1111 1111 1111 2222 2222 2222 2222 2323 3333 3232 2222
2222 1111 1111 1111 1111 1111 1111 1111 2222 2222 2222 2222 3322 2222 2222
2222 2222 2222 2222 2222 2222 2222 2222 2222 2222 2222 2222 2222 2222 2222
14 9 0
20
G 12 6 3
G 11 7 3
G 12 8 3
G 13 7 3
G 3 2 1
G 2 1 1
G 1 2 1
G 2 3 1
L 2 2 3
L 10 2 1
M 3 6 50
M 5 6 50
M 2 7 100
M 6 7 100
M 7 8 150
M 1 8 150
C 13 2
C 7 2
B 4 8
D 12 7
3
S 0 0 R
F 14 0 R 2
H 14 5 L
75