15 10
2222 2222 2222 2222 2222 2222 2222 2222 2222 2222 2222 2222 2222 2222 2222
2222 2222 2255 2222 2222 2222 2222 2222 2222 2222 2222 2222 2222 2222 2222
2222 2525 5555 5252 2222 2222 2222 4444 4444 4444 4444 4444 4444 4444 2222
2222 2222 5522 2222 2222 2222 2222 2222 4444 4444 4444 4444 4444 2222 2222
2222 2222 2222 2222 2222 2222 2222 2222 2222 4444 4444 4444 2222 2222 2222
2222 2222 2222 2222 2211 2222 2222 2222 2222 2222 4422 2222 2222 2222 2222
2222 2222 2222 1111 1111 1111 2222 2222 2222 2222 2222 2222 2233 2222 2222
2222 2222 1111 1111 1111 1111 1111 2222 2222 2222 2222 2323 3333 3232 2222
2222 1111 1111 1111 1111 1111 1111 1111 2222 2222 2222 2222 3322 2222 2222
2222 2222 2222 2222 2222 2222 2222 2222 2222 2222 2222 2222 2222 2222 2222
1 0 2
7
M 0 2 2
L 0 3 100
M 0 3 3
G 0 0 0
C 2 2
B 1 2
D 1 3
3
F 1 3 L 0
S 1 3 L
H 0 3 L
180