15 10
3333 3333 3333 3333 3333 3333 3333 3333 3333 3333 3333 3333 3333 3333 3333
3333 3333 3333 3333 4444 4444 4444 1111 1111 3333 3333 3333 3333 3333 3333
3333 3333 3333 4444 4444 4444 4444 1111 1111 1111 3333 3333 3333 3333 3333
3333 3344 4444 4444 4444 4444 4444 1111 1111 1111 1111 3333 3333 3333 3333
3333 4444 4444 4444 4444 4444 4440 1131 1111 1111 1111 1111 1313 3333 3333
3333 3333 0000 0000 0000 0000 0400 1555 5555 5555 5555 5555 5555 5353 3333
3333 3030 0000 0000 0000 0000 0000 5555 5555 5555 5555 3333 3333 3333 3333
3333 3333 3333 0000 0000 0000 0000 5555 5555 5555 3333 3333 3333 3333 3333
3333 3333 3333 3333 0000 0000 0000 5555 5555 3333 3333 3333 3333 3333 3333
3333 3333 3333 3333 3333 3333 3333 3333 3333 3333 3333 3333 3333 3333 3333
1 0 2
14
G 13 5 0
G 11 5 2
L 6 8 0
L 7 1 2
M 3 3 50
M 6 1 100
M 10 9 100
M 2 5 150
M 7 9 250
C 14 9
C 0 9
B 10 2
B 2 9
D 8 6
4
S 14 0 L
F 8 8 L 5
H 12 9 U
H 4 0 D
50