15 10
3333 3333 3333 3333 3333 3333 3333 3333 3333 3333 3333 3333 3333 3333 3333
3333 3333 3333 3333 4444 4444 4444 1111 1111 3333 3333 3333 3333 3333 3333
3333 3333 3333 4444 4444 4444 4444 1111 1111 1111 3333 3333 3333 3333 3333
3333 3344 4444 4444 4444 4444 4444 1111 1111 1111 1111 3333 3333 3333 3333
3333 4444 4444 4444 4444 4444 4440 1151 1111 1111 1111 1111 1313 3333 3333
3333 3333 0000 0000 0000 0000 0400 1555 5555 5555 5555 5555 5555 5353 3333
3333 3030 0000 0000 0000 0000 0000 5555 5555 5555 5555 3333 3333 3333 3333
3333 3333 3333 0000 0000 0000 0000 5555 5555 5555 3333 3333 3333 3333 3333
3333 3333 3333 3333 0000 0000 0000 5555 5555 3333 3333 3333 3333 3333 3333
3333 3333 3333 3333 3333 3333 3333 3333 3333 3333 3333 3333 3333 3333 3333
1 0 2
7
M 4 7 150
L 6 8 0
M 6 3 50
G 13 5 0
C 13 8
B 12 2
D 7 6
3
F 1 3 L 0
S 1 3 L
H 0 3 L
180