15 10
4444 4444 4444 4444 4444 4444 4444 4444 4444 4444 4444 4444 4444 4444 4444
4444 2222 1111 1111 1111 1414 4444 4444 4444 4400 4444 4444 4444 4444 4444
4444 2222 2222 2222 4444 4444 4444 4444 4444 0000 4444 4444 0000 4444 4444
4444 2222 2444 2222 2222 2222 2222 2222 2020 0000 0000 0000 0000 4444 4444
4444 2222 4444 4444 4444 4444 4444 4444 4444 0000 0444 4444 0000 4444 4444
4444 2222 4444 4444 4444 4444 4444 4444 0000 0000 0000 0000 0000 4444 4444
4444 2222 2222 2222 2222 4444 4444 4444 4444 0000 4444 4444 4444 4444 4444
4444 2244 4444 4444 2222 4444 4444 4444 4444 0000 5555 5555 5555 4444 4444
4444 4444 4444 4444 2222 5555 5555 5555 5555 5555 5555 4444 5544 4444 4444
4444 4444 4444 4444 4444 4444 4444 4444 4444 4444 4444 4444 4444 4444 4444
3 7 0
13
G 12 8 0
L 12 2 0
M 5 3 50
M 11 6 50
M 0 7 100
M 2 6 150
M 8 5 150
M 2 1 100
M 6 5 250
M 4 8 250
C 9 7
B 11 4
D 5 8
4
S 4 2 R
F 8 7 L 4
H 7 0 L
H 7 9 R
60