15 10
4444 4444 4444 4444 4444 4444 4444 4444 4444 4444 4444 4444 4444 4444 4444
4444 2222 1111 1111 1111 1414 4444 4444 4444 4400 4444 4444 4444 4444 4444
4444 2222 2222 2222 4444 4444 4444 4444 4444 0000 4444 4444 0000 4444 4444
4444 2222 2444 2222 2222 2222 2222 2222 2020 0000 0000 0000 0000 4444 4444
4444 2222 4444 4444 4444 4444 4444 4444 4444 0000 0444 4444 0000 4444 4444
4444 2222 4444 4444 4444 4444 4444 4444 0000 0000 0000 0000 0000 4444 4444
4444 2222 2222 2222 2222 4444 4444 4444 4444 0000 4444 4444 4444 4444 4444
4444 2244 4444 4444 2222 4444 4444 4444 4444 0000 5555 5555 5555 4444 4444
4444 4444 4444 4444 2222 5555 5555 5555 5555 5555 5555 4444 5544 4444 4444
4444 4444 4444 4444 4444 4444 4444 4444 4444 4444 4444 4444 4444 4444 4444
1 0 2
7
M 0 2 2
L 12 2 0
M 0 3 3
G 0 0 0
C 2 2
B 11 4
D 1 3
3
F 1 3 L 0
S 1 3 L
H 0 3 L
180