15 10
5555 5555 5555 5555 5555 5555 5555 5555 5555 5555 5555 5555 5555 5555 5555
5555 5555 5555 5555 5555 5555 5555 5555 5555 5555 5555 5555 5555 5555 5555
5555 5555 5555 5555 2222 2222 2222 2233 2222 2222 2222 5555 5555 5555 5555
5555 5555 5555 5555 2222 3333 3333 3344 3333 3333 2222 5555 5555 5555 5555
5555 5555 5555 5555 2323 3333 3434 4444 4343 3333 3232 5555 5555 5555 5555
5555 5555 5555 5555 2222 3333 3333 4433 3333 3333 2222 5555 5555 5555 5555
5555 5555 5555 5555 2222 2222 2222 3322 2222 2222 2222 5555 5555 5555 5555
5555 5555 5555 5555 5555 5555 5555 5555 5555 5555 5555 5555 5555 5555 5555
5555 5555 5555 5555 5555 5555 5555 5555 5555 5555 5555 5555 5555 5555 5555
5555 5555 5555 5555 5555 5555 5555 5555 5555 5555 5555 5555 5555 5555 5555
1 0 2
7
M 0 2 2
L 0 3 50
M 0 3 3
G 0 0 0
C 2 2
B 1 2
D 1 3
3
F 1 3 L 0
S 1 3 L
H 0 3 L
180