15 10
5555 5555 5555 5555 5555 5555 5555 5555 5555 5555 5555 5555 5555 5555 5555
5555 5555 5255 2222 2222 2222 2222 2222 2222 2222 2222 2222 5555 5555 5555
5555 5555 5555 2222 2222 2222 2222 2233 2222 2222 2222 2222 5555 5555 5555
5555 5555 5555 2222 2222 3333 3333 3344 3333 3333 2222 2222 5555 5555 5555
5555 5555 5555 2222 2323 3333 3434 4444 4343 3333 3232 2222 5555 5555 5555
5555 5555 5555 2222 2222 3333 3333 4433 3333 3333 2222 2222 5555 5555 5555
5555 5555 5555 2222 2222 2222 2222 3311 2222 2222 2222 2222 5555 5555 5555
5555 5555 5555 2222 2222 2222 2222 2112 2222 2222 2222 2222 5525 5555 5555
5500 5555 5555 5555 5555 5555 1111 1111 1111 5555 5555 5555 5555 5555 5500
0000 0505 5555 5555 5555 5555 5555 1155 5555 5555 5555 5555 5555 5050 0000
0 0 2
16
M 9 5 150
M 0 4 50
M 8 2 100
M 3 7 250
L 7 4 0
L 0 9 3
L 14 9 2
G 7 9 0
G 2 1 3
G 12 7 3
G 4 4 2
G 10 4 2
G 7 2 2
C 14 0
B 6 7
D 8 8
3
F 11 7 L 2
S 1 3 L
H 14 8 L
60