15 10
1111 1111 1111 1111 1111 1111 1111 1111 1111 1111 1111 1111 1111 1111 1111
1111 1111 1155 1111 1111 1111 1111 1111 1111 1111 1111 1111 1111 1111 1111
1111 1515 3553 5151 1111 1111 1111 1111 1111 1111 1110 0000 1101 1111 1111
1111 1111 1111 1111 1111 1111 1111 1111 1111 1111 0003 0000 0030 1111 1111
1111 1111 1111 1111 1111 1111 1111 1111 1111 1111 0303 5204 3030 1111 1111
1100 1111 1100 1111 1100 1111 1100 1111 1111 1111 0303 3333 3030 1111 1111
0033 0033 0033 0033 0033 0033 0030 1111 1111 1111 0303 3333 3030 1111 1111
3333 3333 3333 3333 3333 3333 3033 0033 0033 0033 0333 3333 3033 0033 0033
3333 2222 2323 3333 3333 3333 3333 3333 3333 3333 3333 3333 3333 3333 3333
3333 3333 3333 3333 3333 3333 3333 3333 3333 3333 3333 3333 3333 3333 3333
0 1 2
17
M 9 5 150
M 0 4 50
M 8 2 100
M 3 7 250
G 1 2 0
G 2 1 0
G 3 2 0
G 2 8 3
L 11 4 3
L 14 6 0
C 14 0
B 1 4
B 3 4
B 5 4
B 7 4
B 11 2
D 1 8
3
F 11 9 L 3
S 13 3 L
H 14 8 L
60