15 10
0000 0000 0000 0000 0000 0000 0000 0000 0000 0000 0000 0000 0000 0000 0000
0000 1111 1115 1155 1155 1111 1111 1111 1115 1155 1155 1155 1111 1111 0000
0000 1111 1111 1111 1515 5555 1111 1111 1511 5511 5511 5511 5151 1111 0000
0000 1111 1111 1111 1515 5555 1111 1111 1515 1155 1155 1155 5151 1111 0000
0000 1111 1111 1515 5551 5511 1111 1111 1111 1155 5555 1155 1111 1111 0000
0000 1111 1111 1111 5555 5555 1111 1111 1515 5511 5511 5511 5151 1111 0000
0000 1111 1111 1111 5555 5555 1111 1111 1515 1155 1155 1155 5151 1111 0000
0000 1111 1515 5555 5555 5511 1111 1111 1111 1515 5555 5151 1111 1111 0000
0000 1111 1111 1111 1111 1111 1111 1111 1111 1111 1111 1111 1111 1111 0000
0000 0000 0000 0000 0000 0000 0000 0000 0000 0000 0000 0000 0000 0000 0000
0 1 2
7
M 9 5 150
M 1 5 50
M 8 2 100
M 3 7 250
C 14 0
B 14 9
D 8 8
3
F 11 7 L 1
S 2 3 L
H 14 8 L
60