15 10
0000 0000 0000 0000 0000 0000 0000 0000 0000 0000 0000 0000 0000 0000 0000
0000 0111 1115 1155 1155 1111 1111 1111 1115 1155 1155 1155 1111 1111 0000
0000 1111 1111 1111 1515 5555 1111 1111 1511 5511 5511 5511 5151 1111 0000
0000 1111 1111 1111 1515 5555 1111 1111 1515 1155 1155 1155 5151 1111 0000
0000 1111 1111 1515 5551 5511 1111 1111 1111 1155 5555 1155 1111 1111 0000
0000 1111 1111 1111 5555 5555 1111 1111 1515 5511 5511 5511 5151 1111 0000
0000 1111 1111 1111 5555 5555 1111 1111 1515 1155 1155 1155 5151 1111 0000
0000 1111 1515 5555 5555 5511 1111 1111 1111 1515 5555 5151 1111 1111 0000
0000 1111 1111 1111 1111 1111 1111 1111 1111 1111 1111 1111 1111 1110 0000
0000 0000 0000 0000 0000 0000 0000 0000 0000 0000 0000 0000 0000 0000 0000
0 1 2
17
G 1 1 3
L 14 6 3
M 2 5 50
M 3 9 50
M 6 4 100
M 5 0 150
M 8 2 100
M 9 9 100
M 0 9 150
M 9 5 150
M 12 3 250
M 3 7 250
C 14 0
C 1 8
C 10 7
B 14 9
D 7 8
3
S 7 7 L
F 13 8 L 1
H 13 4 L
40