15 10
2345 3450 4501 5012 0123 1234 2345 3450 4501 5012 0123 1234 2345 3450 4501
1234 0000 0000 0000 4444 4444 5555 5555 5555 3333 3333 2222 2222 2222 1234
2345 0000 0000 0000 4444 4444 5555 5555 5555 3333 3333 2222 2222 2222 2345
3450 0000 0000 0000 4444 4444 5555 5555 5555 3333 3333 2222 2222 2222 3450
4501 0000 0000 0000 4444 4444 5555 5555 5555 3333 3333 2222 2222 2222 4501
5012 0000 0000 0000 4444 4444 5555 5555 5555 3333 3333 2222 2222 2222 5012
0123 0000 0000 0000 4444 4444 5555 5555 5555 3333 3333 2222 2222 2222 0123
1234 0000 0000 0000 4444 4444 5555 5555 5555 3333 3333 2222 2222 2222 1234
2345 0000 0000 0000 4444 4444 5555 5555 5555 3333 3333 2222 2222 2222 2345
2345 3450 4501 5012 0123 1234 2345 3450 4501 5012 0123 1234 2345 3450 4501
0 0 2
7
M 9 5 150
M 0 4 50
M 8 2 100
M 3 7 250
C 14 0
B 6 7
D 8 8
3
F 11 7 L 2
S 1 3 L
H 14 8 L
60