15 10
2345 3450 4501 5012 0123 1234 2345 3450 4501 5012 0123 1234 2345 3450 4501
1234 0000 0000 0000 4444 4444 5555 5555 5555 3333 3333 2222 2222 2222 1234
2345 0000 0000 0000 4444 4444 5555 5555 5555 3333 3333 2222 2222 2222 2345
3450 0000 0000 0000 4444 4444 5555 5555 5555 3333 3333 2222 2222 2222 3450
4501 0000 0000 0000 4444 4444 5555 5555 5555 3333 3333 2222 2222 2222 4501
5012 0000 0000 0000 4444 4444 5555 5555 5555 3333 3333 2222 2222 2222 5012
0123 0000 0000 0000 4444 4444 5555 5555 5555 3333 3333 2222 2222 2222 0123
1234 0000 0000 0000 4444 4444 5555 5555 5555 3333 3333 2222 2222 2222 1234
2345 0000 0000 0000 4444 4444 5555 5555 5555 3333 3333 2222 2222 2222 2345
2345 3450 4501 5012 0123 1234 2345 3450 4501 5012 0124 1234 2345 3450 4501
2 0 2
18
G 10 0 3
L 5 8 3
M 0 5 50
M 12 2 50
M 12 4 50
M 12 6 50
M 1 3 100
M 8 2 100
M 9 8 150
M 10 8 150
M 3 7 250
C 0 0
C 14 9
C 0 9
C 9 5
C 14 0
B 6 7
D 10 5
2
F 13 8 L 2
H 14 8 L
40